

NO ./textures/42/grey_wall.xpm
SO ./textures/42/wall22.xpm
WE ./textures/42/wall3.xpm
EA ./textures/42/grey_wall.xpm


F 220,100,0
C 225,30,0



111111111111111111111111111111111111111111111
110000000001111111111111111111111100000000011
110000000001111111111111111111111100000000011
110000000001111111111111111111111100000000011
110000100001111111111111111111111100001000011
110000000001111111111111111111111100000000011
110000000001111111111111111111111100000000011
110000000001111111111111111111111100000000011
110000000001000000000000000000000000000000011
110000000000000000000000000000000000000000011
110000000000000000000000000000000000000000011
111111111111111101111111111111111111111111111
111111111111111101111111111111111111111110011
111111111111111101111111111111111111111110011
111111111111111101111111111111111111111110011
111111111111111101111111111111111111111110011
111111100000000000000000000000000000000000011
111111100000000000001110000000000000N00000011
111111100000000000001110000000000111111110011
111111111111011111111111111111000110011000011
111111111111011111111111111111000111111010011
111111111111011111111111111111000100011110011
110000000000011111111111111111000100011000011
110000000000011111111111111111000100011010011
110000000000011111111111111111000111111110011
110000000000011111111111111111000100011010011
110000000000011111111111111111000100011000011
110000000000011111111111111111000000011110011
110000000000011111111111111111000100011000011
110000000000011111111111111111000100011010011
110000000000011111111111111111000110111110011
110000000000011111111111111111000000000000011
110000000000011111111111111111000000000000011
111111111111111111111111111111111111111111111