

NO ./textures/42/grey_wall.xpm
SO ./textures/42/grey_wall.xpm
WE ./textures/42/grey_wall.xpm
EA ./textures/42/grey_wall.xpm


F 220,100,0
C 225,30,0



111111111111111111111111111111111111111111111
110000000001111111111111111111111100000000011
110000000001111111111111111111111100000000011
110000000001111111111111111111111100000000011
110000000001111111111111111111111100000000011
110000000001111111111111111111111100000000011
110000000001111111111111111111111100000000011
110000000001111111111111111111111100000000011
110000000001000000000000000000000000000000011
110000000000000000000000000000000000000000011
110000000000000000000000000000000000000000011
111111111111111100011111111111111111111111111
111111111111111100011111111111111100000000011
111111111111111100011111111111111100000000011
111111111111111100011111111111111100000000011
111111111111111100011111111111111100000000011
111111100000000000000000000000000000000000011
111111100000000000000000000000000000N00000011
111111100000000000000000000000000111111110011
111111100000000000000000000000000110010000011
111111111111011111111111111111000111110010011
111111111111011111111111111111000100011110011
110000000000011111111111111111000100010000011
110000000000011111111111111111000100010010011
110000000000011111111111111111000111111110011
110000000000011111111111111111000100010010011
110000000000011111111111111111000100010000011
110000000000011111111111111111000000011110011
110000000000011111111111111111000100010000011
110000000000011111111111111111000100010010011
110000000000011111111111111111000110111110011
110000000000011111111111111111000000000000011
110000000000011111111111111111000000000000011
111111111111111111111111111111111111111111111