/NO ./textures/walls1/biala.xpm
/SO ./textures/walls1/code.xpm
/WE ./textures/walls1/wall_north.xpm
/EA ./textures/walls1/brick.xpm

NO ./textures/walls1/gray_bumpy_wall.xpm
SO ./textures/walls1/code.xpm
WE ./textures/walls1/white_brick.xpm
EA ./textures/walls1/brick.xpm


[key] [type] [frame_number] [int speed]
ANIMATION B 8 2
./textures/animation/wallking_disk/disk1.xpm
./textures/animation/wallking_disk/disk2.xpm
./textures/animation/wallking_disk/disk3.xpm
./textures/animation/wallking_disk/disk4.xpm
./textures/animation/wallking_disk/disk5.xpm
./textures/animation/wallking_disk/disk6.xpm
./textures/animation/wallking_disk/disk7.xpm
./textures/animation/wallking_disk/disk8.xpm

F 220,100,0
C 225,30,0


11111111111111111111111111111111111111111111111111111111111111111111111111111111111111111111111
10011100000000111000000001110000000011100000000111000000001110000000011100000000101110000000001
10011001111110011001100111100111111000011111100001111110000000011111111001100001100001100111101
10011100000000111000000001110000000011100000000111000000001110000000011100000000111000001000101
11100110000001111110011100000011000011110011111111001100000000110011110000001100001111000000011
10011100000000111000000001110000000011100000000111000000001110000000011100000000111010000000001
10011111100111111000011110011111111110011111100001100111111111100111100001100111111000011110001
10011100000000111000000001110000000011100000000111000000001110000000011100000000111000000000101
10011111100001100001111001100001100001111110000000011110000110000000011111100000000110011001111
10011100000000111000000001110000000N00111000000001110000000011100000000111000000000011100000001
11111110000111111001110000000011100000000111111000011000011000000110000011110011100000000110001
10011100000000111000000001110000000011100000000111000000001110001110000111000000001110000000001
10011000011111100110011111111000000111111110011000011110011001100111111000011111111000011001111
10011100000000111000000001110000000011100000000111000000001110000000011111000000001110000000001
10011100000000111000000001110000000011100000000111000000001110000000000111000000001110000000001
10011100000000111000000001110000000011100000000111000000001110000000011100000000111111000000001
10000110000000011111100110000111100110000001111110011000001100111000000110000000011111111111111
10011100000000111000000001110000000011100000000111000000001110000000000111000000001110000000001
10011111100111100000011000011110011001100001111110000111100111111000000001111001111001100111101
10011100000000111000000001110000000011100000000111000000001110000000000001000000001110000000001
10011100000000111000000001110000000011100000000111000010000011100000000111000000001110000000001
10011100000000111000000001110000000011100000000111000000000111100000000111000000001110000000001
11100001111111100000011001100000011110011110000110011001100110000001111000000111100110011000011
10011100000000111000000001110000000011100000000111000000001110000000000111000000001110000000001
10000110000110000111100000011000011111100001111001111110000000011000011111100001111001100110001
10000110000110000111100000011000011111100001111001111110000000011000011111100001111001100110001
10000110000110000111100000011000011111100001111001111110000000011000011111100001111001100110001
10011100000000111000000001110000000000111000000001110000000011100000000111000000001110000000001
10011000011001111000011000011001100110011110011110000111111001100111111000000001100110000000011
10011100000000111000000001110000000000111000000001110000000011100000000111000000001110000000001
10000110000110000111100000011000011111100001111001111110000000011000011111100001111001100110001
10000001111110000110000111111100000011001111110011100000011000011001100111100000000111111001111
10011100000000111000000001110000000000111000000001110000000011100000000111000000001110000000001
11100000011000000110011110000111111001111110000001111001111001100111111110011000000111111000101
10011100000000111000000001110000000000111000000001110000000011100000000111000000001110000000001
11100000011000000110011110000111111001111110000001111001111001100111111110011000000111111000101
10000110000110000111100000011000011111100001111001111110000000011000011111100001111001100110001
10011100000000111000000001110000000011100000000111000000001110000001110001000000001110000000001
11100000011000000110011110000111111001111110000001111001111001100111111110011000000111111000101
10011100000000111000000001110000000011100000000111000000001110000000011100000000001110000000001
10011110011111111111100001111001111001110000000000110000111111110011100000000001111110000000111
10011100000000111000000001110000000011100000000111000000001110000000011100000000001110000000001
11111111111000011001100000011000011110011111100000011110000000011001100001111001111111100110011
10000110000110000111100000011000011111100001111001111110000000011000011111100001111001100110001
11100000011000000110011110000111111001111110000001111001111001100111111110011000000111111000101
10011100000000111000000001110000000011100000000111000000001110000100000111000000001110000000101
11100000011000000110011110000111111001111110000001111001111001100111111110011000000111111000101
10011100000000111000000001110000000011100000000111000000001110000000011100000000111000000001111
11111111111000011001110000000011100000000111000000000011110000000011001100001111001111111100111
10000110000110000111100000011000011111100001111001111110000000011000011111100001111001100110001
11111111111000011001100000011000011110011111100000011110000000011001100001111001111111100110011
10011100000000111000000001110000000011100000000111000000001110000000111111111000001110000000101
10011001100000000111111000000111111001111000011111100001111001100110011001111111111110000001101
10011100000000111000000001110000000011100000000111000000001110000000011100000000011100000001101
10000001111110011001100111000000001111000011111111000000110011111100111111001111110000111110001
10000110000110000111100000011000011111100001111001111110000000011000011111100001111001100110001
10011100000000111000000001110000000011100000000111000000001111100000000111000000001110000000001
11100000011000000110011110000111111001111110000001111001111001100111111110011000000111111000101
10011100000000111000000001110000000011100000000111000000001110000000011100000000111000000000001
11100000011000000110011110000111111001111110000001111001111001100111111110011000000111111000101
10000110000110000111100000011000011111100001111001111110000000011000011111100001111001100110001
10011100000000111000000001110000000011100000000111000000001110000000011100000000111000000000001
10011100000000111000000001110000000011100000000111000000001110000000011100000000111000000001111
10011111100001111001110000000000110011100000011001100111100111100000011111111001100110000001101
10000110000110000111100000011000011111100001111001111110000000011000011111100001111001100110001
10011100000000111000000001110000000011100000000111000000001110000000011100000000111000000000101
10011111111001111110000111111111100001100000011110000001111000011111111111100111000000000011101
11111111111111111111111111111111111111111111111111111111111111111111111111111111111111111111111



