/NO ./textures/walls1/biala.xpm
/SO ./textures/walls1/code.xpm
/WE ./textures/walls1/wall_north.xpm
/EA ./textures/walls1/brick.xpm

NO ./textures/walls1/gray_bumpy_wall.xpm
SO ./textures/walls1/code.xpm
WE ./textures/walls1/white_brick.xpm
EA ./textures/walls1/brick.xpm


[key] [type] [frame_number] [int speed]
ANIMATION B 8 2
./textures/animation/wallking_disk/disk1.xpm
./textures/animation/wallking_disk/disk2.xpm
./textures/animation/wallking_disk/disk3.xpm
./textures/animation/wallking_disk/disk4.xpm
./textures/animation/wallking_disk/disk5.xpm
./textures/animation/wallking_disk/disk6.xpm
./textures/animation/wallking_disk/disk7.xpm
./textures/animation/wallking_disk/disk8.xpm

F 220,100,0
C 225,30,0


11111111111111111111111111111111111111111111111111111111111111111111111111111111111111111111111
10000000000000100000001000000000000010000000001000000000100000000000001000001000001000000000001
10011001111110011001100111100111111000011111100001111110001000011111111001100001100001100111101
10001000100010000010001000100000001000100000001000100010001000100000001000001000100010001000101
11100110001001111110001000100110000111100111111110011000100001100111100010011000011110001000101
10000000100000000010000010000000100000100000001000100010001000000000100010001000000010000010001
10011111100111111000011110011111111110011111100001100111111111100111100001100111111000011110001
10000000001000001000001000100010001000000010001000000000100000100000100000100000100010001000101
10011111100001100001111001100001100001111110001000011110000110001000011111100010000110011001111
100000001000001000100000100010000N1000000000100010000000100010001000100000001000100000100010001
11111110000111111000011110011110011000011111100001100001100010011000100001111000100010000110001
10000010000000001000100000000010000010000000100010001000001000100010001000000010001000100010001
10011000011111100110011111111000100111111110011000011110011001100111111000011111111000011001111
10001000100010000000100000100010001000000010000010000010001000100000100010000010000010001000001
10000110001000011111100110000111100110001001111110001000100110001000100110001000011111111111111
10000000100000001000001000100000100010001000000000100000100010001000100010001000000000000000001
10011111100111100010011000011110011001100001111110000111100111111000100001111001111001100111101
10001000001000001000100000100010001000001000100000100010000000001000001000100000001000100010001
11100001111111100010011001100010011110011110000110011001100110001001111000100111100110011000011
10001000100000100010001000001000000000100010001000001000100010001000000010001000100010000010001
10000110000110000111100010011000011111100001111001111110001000011000011111100001111001100110001
10000010001000100010001000100010000010001000100000100000100010001000100000100000001000100010001
10011000011001111000011000011001100110011110011110000111111001100111111000100001100110001000011
10001000001000100010000010001000100000100010000010001000001000100000000010001000100010001000001
10001001111110000110000111100010001001100111111000100010011000011001100111100010000111111001111
10000010000000100000100000001000001000100010001000100010000010001000100000100000100000001000001
10011110011111111111100001111001111000100010001001100001111111100010001000100111111110001000111
10000000100010000000100010001000000010001000100010001000100010001000001000001000000000100010001
11111111111000011001100010011000011110011111100010011110001000011001100001111001111111100110011
10000000001000100000001000100010000010000010000010001000001000001000100000000010000000100000101
10011001100010000111111000100111111001111000011111100001111001100110011001111111111110001001101
10000010000010000000001000100000000010001000000000100000100000000010000010000000000010001000101
10001001111110011001100010001000011110000111111110001001100111111001111110011111100001111110001
10001000000010000010000010001000000000100000100010001000001000001000000010001000100000000010001
11100010011000100110011110000111111001111110001001111001111001100111111110011000100111111000101
10001000001000001000001000100000001000001000100000100010000010001000000000100010000010001000101
10011111100001111000100010001001100010001001100110011110011110001001111111100110011000100111101
10001000100000001000100010000010001000100010001000000000100000100010001000100010000000100000101
10001000100110000110011111111110011111100010011001111110011001100010000110011000011111111110011
10000010001000100000100000000000100000100010000000100010000010001000100000001000100010001000101
10011111111001111110000111111111100001100010011110001001111000011111111111100010001000100111101
11111111111111111111111111111111111111111111111111111111111111111111111111111111111111111111111