/NO ./textures/walls1/biala.xpm
/SO ./textures/walls1/code.xpm
/WE ./textures/walls1/wall_north.xpm
/EA ./textures/walls1/brick.xpm

NO ./textures/walls1/gray_bumpy_wall.xpm
SO ./textures/walls1/code.xpm
WE ./textures/walls1/white_brick.xpm
EA ./textures/walls1/brick.xpm


[key] [type] [frame_number] [int speed]
ANIMATION B 8 2
./textures/animation/wallking_disk/disk1.xpm
./textures/animation/wallking_disk/disk2.xpm
./textures/animation/wallking_disk/disk3.xpm
./textures/animation/wallking_disk/disk4.xpm
./textures/animation/wallking_disk/disk5.xpm
./textures/animation/wallking_disk/disk6.xpm
./textures/animation/wallking_disk/disk7.xpm
./textures/animation/wallking_disk/disk8.xpm

F 220,100,0
C 225,30,0




                     111
                     101
                     101
                     101
                     101
                     101
                     101
                     101
                     101
                     101
                     101
11111111111111111111110111111111111111111111111
1000000000000000000000N000000000000000000000001
11111111111111111111110111111111111111111111111
                     101
                     101
                     101
                     101
                     101
                     101
                     101
                     101
                     101
                     101
                     101
                     101
                     101
                     111


