/NO ./textures/walls1/biala.xpm
/SO ./textures/walls1/code.xpm
/WE ./textures/walls1/wall_north.xpm
/EA ./textures/walls1/brick.xpm

NO ./textures/walls1/gray_bumpy_wall.xpm
SO ./textures/walls1/code.xpm
WE ./textures/walls1/white_brick.xpm
EA ./textures/walls1/brick.xpm


[key] [type] [frame_number] [int speed]
ANIMATION B 8 2
./textures/animation/wallking_disk/disk1.xpm
./textures/animation/wallking_disk/disk2.xpm
./textures/animation/wallking_disk/disk3.xpm
./textures/animation/wallking_disk/disk4.xpm
./textures/animation/wallking_disk/disk5.xpm
./textures/animation/wallking_disk/disk6.xpm
./textures/animation/wallking_disk/disk7.xpm
./textures/animation/wallking_disk/disk8.xpm

F 220,100,0
C 225,30,0






        11111111111111111111111111111111111111111111111111111111
        10000000001100000000000000000000000000000000000000000001
        10110000011100000000000011111111111111111111111111111111
        1001000000000000000000001
111111111011000001110000000000001
10000000001100000111000B0011111111111111
11110111111111011100000000000000000000W1
1111011111111101110100000000111111111111
11000000110101011100000110001
10000000000000001100000010001
10000000000000001101010010001
11000001110101011111011110011
11110111111101011101111010001
11111111111111111111111111111