/NO ./textures/walls1/biala.xpm
/SO ./textures/walls1/code.xpm
/WE ./textures/walls1/wall_north.xpm
/EA ./textures/walls1/brick.xpm

NO ./textures/walls1/gray_bumpy_wall.xpm
SO ./textures/walls1/code.xpm
WE ./textures/walls1/white_brick.xpm
EA ./textures/walls1/brick.xpm


[key] [type] [frame_number] [int speed]
ANIMATION B 8 2
./textures/animation/wallking_disk/disk1.xpm
./textures/animation/wallking_disk/disk2.xpm
./textures/animation/wallking_disk/disk3.xpm
./textures/animation/wallking_disk/disk4.xpm
./textures/animation/wallking_disk/disk5.xpm
./textures/animation/wallking_disk/disk6.xpm
./textures/animation/wallking_disk/disk7.xpm
./textures/animation/wallking_disk/disk8.xpm

F 220,100,0
C 225,30,0


11111111111111111111111111111111111111111111111111111111111111111111111111111111111111111111111
10100000000000100000001000000000000010000000001000000000100000000000001000001000001000000000001
10011001111110011001100111100111111010011111101001111110101010011111111001101001101001100111101
10001000100010000010101000101000001000100000001000100010101010100000001010001010100010101000101
11100110101001111110101010100110100111100111111110011010101001100111101010011010011110101010101
10100000101000000010100010100000100000100000001000100010001000000000101010001000000010100010101
10011111100111111010011110011111111110011111101001100111111111100111101001100111111010011110101
10000000001000001000001000100010001000000010001010000000100000101000100000101000100010001000101
10011111101001101001111001101001101001111110101010011110100110101010011111101010100110011001111
100000001010001000100000100010000N1010000000101010100000101010101010100000001010101000100010001
11111110100111111010011110011110011010011111101001101001101010011010101001111010101010100110101
10000010100000001010100000000010100010000000101010001010001000100010001010000010001010100010101
10011010011111100110011111111010100111111110011010011110011001100111111010011111111010011001111
10001010100010100000100000100010101000000010000010100010101000101000100010100010000010001000001
10100110101010011111100110100111100110101001111110101010100110101010100110101010011111111111111
10100000101000001000001010100000100010101010000000101000100010001010101010001010000000000000001
10011111100111101010011010011110011001101001111110100111100111111010101001111001111001100111101
10001000001000001010100000100010001000001000100000100010000000001010001000101000001000100010001
11101001111111101010011001101010011110011110100110011001100110101001111010100111100110011010011
10101000100000101010001010001010000000100010001000001000101010101010000010001000100010100010101
10100110100110100111101010011010011111101001111001111110101010011010011111101001111001100110101
10100010001000100010001010100010000010001000100000100000100010001000100000101000001000101010101
10011010011001111010011010011001100110011110011110100111111001100111111010101001100110101010011
10001010001000100010100010001010101000100010000010101000001010100000000010101010100010001010001
10101001111110100110100111101010101001100111111010101010011010011001100111101010100111111001111
10100010000000100000101000001010001010100010001010101010000010001010101000101000100000001010001
10011110011111111111101001111001111010101010101001101001111111101010101010100111111110101010101
10000000100010000000101010001010000010001000101010001000100010001010001010001000000000100010101
11111111111010011001101010011010011110011111101010011110101010011001101001111001111111100110011
10000000001010101000001010100010000010000010100010001010001010001000101000000010000000101000101
10011001101010100111111010100111111001111010011111101001111001100110011001111111111110101001101
10100010000010100000001010101000000010001000000000101000100000000010000010000000000010001000101
10101001111110011001101010101010011110100111111110101001100111111001111110011111101001111110101
10101010000010100010100010101010000000100000100010001000001000001000000010001000101000000010101
11101010011010100110011110100111111001111110101001111001111001100111111110011010100111111010101
10001010001010001000001000101000001010001000101000100010000010101000000000100010100010001000101
10011111101001111010101010101001101010101001100110011110011110101001111111100110011010100111101
10001000101000001010100010100010001000101010001010000000100000101010001000100010100000100000101
10101010100110100110011111111110011111101010011001111110011001101010100110011010011111111110011
10100010001000100000100000000000100000101010100000100010000010001000100000001010100010001000101
10011111111001111110100111111111101001101010011110101001111010011111111111101010101010100111101
11111111111111111111111111111111111111111111111111111111111111111111111111111111111111111111111