NO ./textures/walls1/wall_north.xpm
SO ./textures/walls1/wall_south.xpm
WE ./textures/walls1/wall_west.xpm
EA ./textures/walls1/wall_east.xpm

/NO ./textures/walls2/wallE.xpm
/SO ./textures/walls2/wallE.xpm
/WE ./textures/walls2/wallE.xpm
/EA ./textures/walls2/wallE.xpm


F 220,100,0
C 225,30,0


        1111111111111111111111111
        1000000000110000000000001
        1011000001110000000000001
        1001000000000000000000001
111111111011000001110000000000001
1000000000110000011100000011111111111111
1111011111111101110000000000000000000001
1111011111111101110100000000111111111111
11000000110101011100000N10001
10000000000000001100000010001
10000000000000001101010010001
11000001110101011111011110011
11110111111101011101111010001
11111111111111111111111111111


