NO ./path_to_the_north_texture
SO ./path_to_the_south_texture
WE ./path_to_the_west_texture
EA ./path_to_the_east_texture


F 220,100,0
C 225,30,0


        1111111111111111111111111
        1000000000110000000000001
        1011000001110000000000001
        1001000000000000000000001
111111111011000001110000000000001
1000000000110000011101111111111111111111
1111011111111101110000001000100000000001
1111011111111101110101001000111111111111
11000000110101011100000010001
1000000000000000110000001N001
10000000000000001101010010001
11000001110101011111011110011
11110111111101011101111010001
11111111111111111111111111111


